M.......M
..EE..EE.
S..M.M..E
.E.S.EE..
..P...P..
